32 16
................................
.##############################.
..............................#.
..............................#.
..............................#.
..............................#.
..............................#.
................................
................................
................................
................................
................................
................................
................................
................................
................................
